10
10
ge,gr,bu,gr,re,gr,bu,gr,bl,gr,
bl,gr,bu,gr,re,gr,gr,gr,gr,gr,
ge,gr,bu,bl,re,gr,bu,gr,bl,gr,
ge,gr,bu,gr,re,ge,re,re,re,bl,
ge,gr,bl,gr,re,bu,bu,gr,bl,gr,
re,gr,br,br,br,br,br,br,br,br,
re,gr,br,gr,ge,bu,bu,gr,bl,gr,
re,gr,bl,gr,ge,bu,bu,gr,bl,bl,
re,gr,br,gr,ge,gr,bu,gr,bl,gr,
re,gr,br,gr,re,gr,bu,gr,bl,bl,